                  ####     #######      
                  #  #     #     #      
                  #  #     #     #      
            #######  #######     #      
            #                    #      
            #................    #      
            #.       #######.    ####   
            #.       #     #.       #   
            #.       #     #....... #   
      #######.    ####     #######. #   
      # ......    #              #. #   
      # .         # ........     #. #   
      # .      #### .######S     #. ####
      # .      #    .#           #.    #
      # .      #    .#           #.    #
####### .      #    .#     #######.    #
#       .      #    .#     #.......    #
#       .      #    .#     #.          #
#       .#######    .#######.    #######
#       .#          .........    #      
#       .#                       #      
####### .#        #######     ####      
      # .#        #     #     #         
      # .#        #     #     #         
   #### .####  ####     #     #         
   #    .   #  #        #     #         
   #    .   #  #        #     #         
   #    .   #  #        #######         
   #    .   #  #                        
   #    ... #  #................        
   #######. ####.       #######.        
         #.......       #     #.        
         #              #     #.        
         #######  #######     #.        
               #  #           #.        
               #  #           #.        
               ####           E.        
